.......................................................
..........................#######################......
..........................#######################......
..........................#######################......
.############.............#######################......
.############.............#######################......
.############.............#######################......
.############.............#######################......
.################################################......
.################################################......
.################################################......
.################################################......
.################################################......
.################################################......
.################################################......
.################################################......
.##############......#################......#####......
.##############......#################......#####......
.##############......#################......#####......
.##############......#################......#####......
.##############......########......###......#####......
.##############......########......###......#####......
.##############......########......###......#####......
.##############......########......###......#####......
.##############......#################......#####......
.##############......#################......#####......
.##############......#################......#####......
.##############......#################......#####......
.##############......#################......#####......
.##############......#################......#####......
.################################################......
.################################################......
.################################################......
.################################################......
.################################################......
.################################################......
.################################################......
......##############################################...
......##############################################...
......##############################################...
......##############################################...
......##############################################...
......######################################...........
......######################################...........
......################################################.
......################################################.
......################################################.
......####################......###################....
......####################......###################....
......####################......###################....
......####################......###################....
......#######...................###....................
......#######...................###....................
......#######...................###....................
......#######...................###....................
......#######...................###....................
......#######...................###....................
......#######...................###....................
......#######..........................................
......#######..........................................